15 15
15 0
3 3 3 0 0 0 5 5 5 0 0 1 0 0 0
3 3 3 1 0 0 5 5 5 0 0 0 0 1 0
3 3 3 0 0 0 0 0 6 6 6 6 6 6 0
0 0 0 4 4 4 4 0 9 8 6 8 8 6 0
1 0 0 4 4 4 4 0 6 8 6 8 8 6 0
0 0 0 0 0 0 0 1 6 8 6 8 8 6 1
0 0 0 0 0 0 0 0 6 8 9 8 8 6 0
3 3 3 0 0 0 5 5 6 8 6 8 8 6 0
3 3 3 0 0 0 5 5 6 6 6 6 9 6 0
3 3 3 0 0 0 5 5 0 0 0 0 0 2 2
0 0 1 0 0 2 2 0 0 7 7 7 0 2 2
0 0 0 0 0 2 2 0 0 7 7 7 0 0 0
0 0 0 0 1 0 0 0 0 7 7 7 1 0 0
2 2 0 0 2 2 0 0 0 7 7 7 1 0 0
2 2 0 0 2 2 0 0 0 7 7 7 0 0 0
